accept = "Aceptar"
action = "Acción"
apply = "Aplicar"
bloom = "Resplandor"
brightness = "Brillo"
bruteforce = "Fuerza Bruta"
cancel = "Cancelar"
chat = "Chat"
connect = "Conectar"
contrast = "Contraste"
decline = "Denegar"
disabled = "Dishabilitar"
enabled = "Activar"
gamemode = "Modo de Juego"
hdrr = "HDRR"
lan_english = "Inglés"
lan_german = "Alemán"
language = "Idioma"
latency = "Latencia"
map = "Mapa"
motion_blur = "Desenfoque de Movimiento"
movement = "Movimiento"
no = "No"
password_protected = "PW"
off = "Apagado"
ok = "Aceptar"
other = "Otros"
players = "Jugadores"
refresh = "Refrescar"
server_name = "Nombre de Servidor"
ssao = "SSAO"
yes = "Sí"