accept = "Akzeptieren"
action = "Aktion"
angle = "Winkel"
angles = "Winkel"
animation = "Animation"
animations = "Animationen"
apply = "Übernehmen"
apply_changes = "Änderungen übernehmen"
arguments = "Argumente"
attachment = "Ansatz"
attachments = "Ansätze"
blendcontrollers = "Blend-Kontroller"
bloom = "Bloom"
bodygroups = "Körpergruppen"
bone = "Knochen"
bones = "Knochen"
brightness = "Helligkeit"
bruteforce = "Brute-Force"
bsp_and_octree = "BSP + Octree"
cancel = "Abbrechen"
chat = "Chat"
chest = "Brust"
class = "Klasse"
clear = "Leeren"
connect = "Verbinden"
contrast = "Kontrast"
concave = "Konkav"
convex = "Konvex"
decline = "Verweigern"
disabled = "Deaktiviert"
enabled = "Aktiviert"
entities = "Entities"
event = "Ereignis"
events = "Ereignisse"
flexes = "Flexes"
fps = "FPS"
frame = "Frame"
gamemode = "Spielmodus"
gameplay = "Spielmechanik"
gear = "Ausrüstung"
hdrr = "HDRR"
head = "Kopf"
hitbox = "Trefferkasten"
hitboxes = "Trefferkästen"
hitgroup = "Treffergruppe"
id = "ID"
import = "Importieren"
info = "Info"
lan_english = "English"
lan_german = "Deutsch"
language = "Sprache"
latency = "Latenzzeit"
left_arm = "Linker Arm"
left_leg = "Linkes Bein"
loop = "Schleife"
map = "Karte"
mass = "Masse"
material = "Material"
materials = "Materialien"
max = "Max"
maximum = "Maximum"
min = "Min"
minimum = "Minimum"
motion_blur = "Bewegungsunschärfe"
movement = "Bewegung"
music = "Musik"
name = "Name"
no = "Nein"
no_limit = "Kein Limit"
none = "Keine"
not_found = "Nicht gefunden"
npcs = "NPCs"
octree = "Octree"
off = "Aus"
offset = "Verschiebung"
ok = "OK"
origin = "Ursprung"
other = "Andere"
password_protected = "PW"
path = "Pfad"
physics = "Physik"
players = "Spieler"
preview = "Vorschau"
properties = "Eigenschaften"
props = "Props"
quality = "Qualität"
refresh = "Aktualisieren"
remove = "Löschen"
reset = "Zurücksetzen"
right_arm = "Rechter Arm"
right_leg = "Rechtes Bein"
server_name = "Server Name"
size = "Größe"
skeleton = "Skelett"
skins = "Häute"
speed = "Geschwindigkeit"
ssao = "SSAO"
stomach = "Bauch"
surface_material = "Oberflächenmaterial"
texture = "Textur"
textures = "Texturen"
tools = "Werkzeuge"
type = "Typ"
unknown = "Unbekannt"
unsupported_extension = "Nicht unterstützte Erweiterung"
value = "Wert"
vehicles = "Fahrzeuge"
view = "Ansicht"
weapons = "Waffen"
yes = "Ja"