accept = "Accepter"
action = "Action"
apply = "Appliquer"
bloom = "Flou lumineux"
brightness = "Luminosite"
bruteforce = "Brute-Force"
cancel = "Annuler"
chat = "Tchat"
connect = "Connecter"
contrast = "Contraste"
decline = "Decliner"
disabled = "Desactive"
enabled = "Active"
gamemode = "Mode de jeu"
hdrr = "HDRR"
lan_english = "Anglais"
lan_german = "Allemand"
language = "Langage"
latency = "Latence"
map = "Carte"
motion_blur = "Flou de Mouvement"
movement = "Mouvement"
no = "Non"
password_protected = "MDP"
off = "Eteint"
ok = "OK"
other = "Autres"
players = "Joueurs"
refresh = "Rafraichir"
server_name = "Nom du serveur"
ssao = "SSAO"
yes = "Oui"